Alcachofra – Ingredientes: Base de muçarela especial fresca, Alcachofras italianas em conserva, Presunto magro, Lascas de parmesão argentino – Preço: R$38,00

Bráz – Ingredientes: Fatias de abobrinha dourada em alho e azeite de oliva, Muçarela especial, Lascas de parmesão argentino, Alecrim fresco – Preço: R$38,00

Calabresa – Ingredientes: Calabresa especial cozida em fatias, Anéis de cebola, Orégano, Azeitonas portuguesas – Preço: R$38,00

Calábria (Vegana) – Ingredientes: Calabresa Vegabon, Cream gourmet Germinou, Azeite aromatizado, Pimenta calabresa, Orégano, Cebola roxa, Azeitona chilena – Preço: R$44,00

CalaCheese – Ingredientes: Muçarela de búfala rasgada, Linguicinhas curadas, Linguicinhas curada apimentada, Muçarela especial – Preço: R$38,00

Canadense – Ingredientes: Fatias finas de lombo canadense, Anéis de cebola, Catupiry® gratinado – Preço: R$36,00

Caprese – Ingredientes: Base de muçarela especial fresca, Fatias de tomate, Fatias de muçarela de búfala, Folhas de manjericão orgânico, Pesto artesanal de azeitonas pretas – Preço: R$40,00

Carbonara – Ingredientes: Base de muçarela fresca, Pedacinhos de bacon, Mix de pimenta, Cobertura de ovos, Grana Padano – Preço: R$40,00

Carnevale (Vegana) – Ingredientes: Base de spread de castanha de caju, Palmito em cubos, Pimentões vermelho e amarelo, Azeite aromatizado, Cebola roxa – Preço: R$40,00

Castelões – Ingredientes: Base de muçarela especial fresca, Fatias finas de linguiça calabresa artesanal – Preço: R$34,00

Da Roça – Ingredientes: Peito de frango cozido e desfiado, Refogado em azeite de oliva e temperos naturais, Cebola, Base de muçarela especial, Bacon em cubos, Catupiry® gratinado – Preço: R$42,00

Escarola Speciale – Ingredientes: Escarola finamente fatiada e temperada, Bacon em cubos, Base de muçarela especial fresca – Preço: R$36,00

Funghi – Ingredientes: Cogumelos shitake e shimeji frescos e orgânicos, Manteiga com alho e salsinha, Base de muçarela especial fresca, Anéis de cebola roxa – Preço: R$38,00

Ibérica – Ingredientes: Jamón serrano espanhol, Lascas de parmesão argentino, Catupiry®, Champignon, Base de muçarela especial, Tomate em cubos (na saída do forno) – Preço: R$42,00

Italianinha – Ingredientes: Lascas de parmesão argentino, Provolone defumado naturalmente, Base de muçarela especial, Fatias de tomate, Folhas de manjericão orgânico – Preço: R$40,00

Jardineira Aliboni – Ingredientes: Peito de frango cozido e desfiado, Temperado com produtos naturais, Refogado em azeite de oliva, Catupiry® gratinado, Orégano, Azeitonas portuguesas – Preço: R$42,00

Julienne – Ingredientes: Base de muçarela especial fresca, Presunto magro rasgado, Grana Padano, Tomatinho sweet grape – Preço: R$38,00

Leggera – Ingredientes: Mix de muçarela de búfala e ricota fresca, Anéis de cebola roxa, Azeitonas chilenas rasgadas, Manjericão roxo orgânico, Cubinhos de tomate, Azeite aromatizado – Preço: R$42,00

Lusa – Ingredientes: Presunto magro, Cebola, Palmito, Ervilha, Base de muçarela fresca, Ovos cozidos espremidos, Orégano, Azeitonas portuguesas – Preço: R$46,00

Mafiosa – Ingredientes: Base de muçarela especial, Champignon laminado, Provolone defumado naturalmente, Parmesão argentino, Fatias de bacon, Fatias de tomate – Preço: R$42,00

Manhattan – Ingredientes: Pepperoni, Champignon, Pimentões amarelo e vermelho, Base de muçarela especial, Anéis de cebola roxa – Preço: R$40,00

Margherita – Ingredientes: Muçarela especial, Muçarela de búfala rasgada, Fatias de tomate, Folhas de manjericão orgânico, Fio de azeite aromatizado – Preço: R$40,00

Marinara – Ingredientes: Alho em conserva artesanal laminado, Lascas de parmesão argentino, Base de muçarela especial fresca, Camada leve de alho dourado em azeite de oliva e triturado – Preço: R$38,00

Mediterrânea – Ingredientes: Fatias de tomate, Berinjela, Abobrinha marinadas em alho, azeite e ervas, Base de muçarela, Alecrim fresco, Azeitonas chilenas rasgadas – Preço: R$42,00

Mooca – Ingredientes: Base de muçarela especial fresca, Paris orgânico, Presunto magro, Catupiry® gratinado, Parmesão argentino, Orégano – Preço: R$42,00

Muçarela – Ingredientes: Muçarela especial fresca, Orégano, Azeitonas portuguesas – Preço: R$36,00

Netuno – Ingredientes: Atum sólido, Anéis de cebola, Ervilha, Palmito, Champignon fatiado, Muçarela especial fresca – Preço: R$42,00

Palmito – Ingredientes: Base de muçarela fresca, Fatias de palmito, Catupiry® gratinado, Azeitonas chilenas, Orégano – Preço: R$40,00

Parmigiana – Ingredientes: Muçarela de búfala, Muçarela especial, Molho artesanal, Parmesão Faixa Azul ralado, Manjericão orgânico – Preço: R$40,00

Paulistana – Ingredientes: Base de muçarela especial fresca, Linguiça calabresa defumada, Anéis de cebola, Orégano, Azeitonas portuguesas – Preço: R$40,00

Quatro Queijos – Ingredientes: Provolone defumado naturalmente, Gorgonzola premiatto, Catupiry® gratinado, Muçarela especial fresca, Orégano, Azeitonas portuguesas – Preço: R$42,00

Raschietto – Ingredientes: Creme de ricota, Muçarela de búfala, Abobrinha marinada em temperos naturais, Parmesão argentino, Fatias de bacon, Raspas de limão – Preço: R$42,00

Romana – Ingredientes: Molho artesanal de pelati italiani, Alici, Azeite aromatizado – Preço: R$36,00

Popeye – Ingredientes: Base de muçarela especial fresca, Espinafre, Ovos, Salaminho diavoletti – Preço: R$38,00

Tacchino – Ingredientes: Fatias rasgadas de peito de peru defumado, Catupiry®, Alho poró, Orégano – Preço: R$38,00

Vêneto – Ingredientes: Palmito, Champignon, Provolone defumado naturalmente, Base de muçarela especial fresca, Catupiry® gratinado, Orégano, Azeitonas portuguesas – Preço: R$44,00

Tonno Capparis – Ingredientes: Atum sólido, Alcaparras, Cebola roxa, Azeitona chilena, Azeite aromatizado – Preço: R$40,00